"a" = (/turf/open/floor/grass,/area/barony)
"b" = (/obj/effect/landmark/observer_start,/obj/effect/landmark/latejoin,/turf/open/floor/grass,/area/barony)
"c" = (/turf/closed/indestructible/rock,/area/barony)

(1,1,1) = {"
ccccccccccccccccccccccccc
caaaaaaaaaaaaaaaaaaaaaaac
caaaaaaaaaaaaaaaaaaaaaaac
caaaaaaaaaaaaaaaaaaaaaaac
caaaaaaaaaaaaaaaaaaaaaaac
caaaaaaaaaaaaaaaaaaaaaaac
caaaaaaaaaaaaaaaaaaaaaaac
caaaaaaaaaaaaaaaaaaaaaaac
caaaaaaaaaaaaaaaaaaaaaaac
caaaaaaaaaaaaaaaaaaaaaaac
caaaaaaaaaaaaaaaaaaaaaaac
caaaaaaaaaaaaaaaaaaaaaaac
caaaaaaaaaaaaaaaaaaaaaaac
caaaaaaaaaaaaaaaaaaaaaaac
caaaaaaaaaaaaaaaaaaaaaaac
caaaaaaaabaaaaaaaaaaaaaac
caaaaaaaaaaaaaaaaaaaaaaac
caaaaaaaaaaaaaaaaaaaaaaac
caaaaaaaaaaaaaaaaaaaaaaac
caaaaaaaaaaaaaaaaaaaaaaac
caaaaaaaaaaaaaaaaaaaaaaac
caaaaaaaaaaaaaaaaaaaaaaac
caaaaaaaaaaaaaaaaaaaaaaac
caaaaaaaaaaaaaaaaaaaaaaac
ccccccccccccccccccccccccc
"}
